242231104032041
414441123033221
012241012023140
010313023333412
031420344101333
033431002040113
321044030423144
222033123322114
243011413212413
030202143034034
130243232040040
013143403421204
024021344403023
332441000121140
203241410123043
#
321034004200421
243410201203010
124231220143312
403120312400424
122110220141223
123443002001000
212122423320002
334311312224322
111142331324412
403103443423322
024221144211432
343143334003204
014102034324043
204221042140324
142322004142122
#
423313422014201
211113324313232
200123121421210
132104121244001
212030323332423
420401102314130
003221143430402
403034420213344
101403002043243
332430113134211
440242033323101
123233133212033
222123300123244
022213422240321
021404144202300
#
230023224103200
231122044004024
402340041243131
434342101003240
424330110432114
402144230123414
244203420323224
120321000144431
432242403023441
403042102133124
244002040040203
314013023311231
422034243041023
303400422212410
111412242020143
#
103321114214032
332113243031434
020323413341142
100200144322132
033400214220304
040103121323440
102442334224333
230304241033303
113313212103342
342022440401304
144044310341003
130341244042110
212024413141242
143422242313023
040041344312100
#
024114040314202
302042120042144
331401031042414
133000242231401
300110302031022
042124203130122
200121120321444
042232141122444
213024430434332
103021311344343
314120221110134
120230200021410
334000421232400
241240034401421
304322311340432
#
331031311110100
130422022003241
312231320130320
022302123014131
111320403412400
203240244311104
412001440144410
140110321224304
010124404232434
321433314421020
014024004434010
204341423213300
210324121204414
242010221413324
322112114422043
#
213313022122224
240241140234424
242433101244331
412204340113313
111044041134321
143312230311234
124143430203404
400341203110341
301212400011301
422100141133113
132102432112112
413121234110420
124012034201344
431133331042001
112113234220130
#
203414112402040
331111332032201
002431220401332
003223203331043
011234121304131
202412130143144
343333041212402
233111324322104
010214432422231
400323233130003
420310212413432
120114402142301
030022142333431
142402404031242
132424320121144
#
200332342421424
321203442111204
333411412204430
331342232444124
421024412022402
024421313334221
242031401102234
112010422414410
140340441200342
231343210234101
312404043442023
034130443421102
432422304310213
002121243140011
403040421140302
#
131342234201330
101041230304131
141414323320221
043400224200202
304013231030413
041330444003013
441304014403220
310314400043030
133042120303314
023010303302023
301320211334130
313314311134024
441432433111021
403422402002124
222102431041430
#
044440113232133
024133004002203
142011241044144
001221333114420
343221333344410
123410012142403
423041421333001
322001212024020
204220310440300
011124213420233
131433424314400
413331302320042
221404400012202
302413041130013
040243003204111
#
133402142033010
220003242122124
311424344041221
340003443440400
401030343414123
223421143340011
334220203203133
014121334244110
232311224111230
403320014223003
313312332130413
241201324314103
120243213002133
424104213021121
001340130011232
#
020124001323244
122224122211232
030444322404214
423040111041420
130222211232231
323331221142213
143044222132300
440232133301104
311433100440001
304430412032331
022012414032031
022311142033144
134041113221243
124142222014132
144002421230040
#
104312410110140
202044204444434
212423033201440
332034143142103
133333140343024
101203042312042
022324224424343
112224311303232
201311202113130
310023132102041
300041144423442
233430010141403
130412301432414
201010410401402
102222324001333
#
340003130221322
004220033431104
344141013043102
043123232040434
310003201412134
130340103443334
342131210041004
443221401230132
221134301031420
324423124114333
413133430031042
021111240222013
131004144141414
233044443230240
002400212041413
#
134024012011031
433002142212042
331232140424044
223214041324134
324304331333120
241434330211304
430443114140123
303142341332313
343004224112004
244200404143013
340144343023420
010022113322343
412111403140313
444332303111444
203022314343010
#
422033340341020
213430344433113
300023441034210
330202004310122
434132240400234
022413011413102
040020403233242
340303120424133
334411120232023
204124210214324
332443244434224
411311231130342
142013001240342
124432104334214
002030040311240
#
002133000101044
124234433334214
012131133312243
141203432241331
444103233241330
140424041111242
400340001333040
142313414100221
211122422341032
333122323314412
012341030402433
332442303323234
102212431140441
134044441020112
103303342330032
#
141444210301411
203313022430042
202223031313043
032001040324200
222111023403224
001432242021113
114144400212011
402001412012404
130224020344042
444034320302203
143114334313022
413221021221223
010243040232114
144243041200344
042402131314321