311410404411023
332044131200404
023430300344111
234023024443023
121312012103401
044303422202340
243423111341031
100403121041331
133204313041003
033423002123401
041201343341404
223104012413301
330232143130213
103214444042134
101011221001432
#
330102123231110
413403322402400
232203104402404
034422133130334
002121343212314
124200011100244
103332104241430
443302334303004
333143330420320
241111400304043
330141211034210
223320433404331
013212110241403
414021313140103
132322422430311
#
424310332243142
303403332443133
204401222340440
043002421203242
020201132112340
101043334222341
234342242434401
423220124330021
344304341002143
401310230202301
420002210231131
031133212004241
214440334200200
104401324042001
222233043340412
#
422413324042342
202121012113042
023200410430032
223110010114300
420422030022142
143323044002230
211410104410413
330213114023333
233131041012304
321134024242020
030140004210240
201423142010342
042034431134214
424043022414341
432221123312032
#
344323213412332
202031031121434
131031323400141
021022241044332
231304023014423
313323010434014
444223000101213
213440410401213
343120133014200
230124330112233
441033442242030
310432023143122
223024130321342
243130320432234
042223201140133
#
242042231013420
233231330141001
043031333102421
301012300211144
011120213420310
111411001141121
330113200001201
030340112142102
122223413142411
220330223322103
240040434434144
212311221031440
232211401440433
113031434104114
044422431132441
#
340312013124113
314300130204444
043211022134023
240133322220220
040021014333102
104124422000344
421312013422132
111030313311230
124314111023033
041340414042301
043424131304300
311104203044244
404314132301011
334244203430103
023442410004240
#
313144220402231
112331022202411
441242141233214
102234132213432
311001203243431
113042130124403
011101233101003
232311124021233
013043114013030
133030003413000
442131011313243
030231113312322
322030310033242
012202441343114
443043334134431
#
134021430012311
003032301403332
241201210031022
021211000330113
142313304231044
211411404420040
344300204124033
140400334402244
010423300204341
311424002031243
004241200030333
001012203432434
110204331143241
012234031400311
030010111312000
#
013343432440321
401100012030021
124302023431223
343013323110342
200320233301111
242214321401441
000223432303434
120412240242403
343311044210013
122243202101013
234210123240243
132430441141240
302214341221131
202104140323024
031101414111042
#
412023414414313
131340342332341
132234234034123
132402001213442
402201100102324
220341043442334
440203411442011
310411132413202
020011204110224
310434311003234
441240420323400
243013131010014
121200301102312
320130243444030
233022430212320
#
122423424122334
311411111211410
141442140340233
331203332401230
434130443404002
203124440023003
040342110333221
020314001203412
322211143202422
433030040022331
423412313044402
013123243312401
413310320140202
402410042004430
111342321201410
#
401433141241002
014030024223324
021033300443114
442102433224240
300442213432420
041444441234233
012002213420041
433200101432311
342202333001213
132122411123131
002121141102120
412103103404332
430034333311321
011301104040204
221442203430243
#
224024001403433
043103201221440
212332123304210
443324101440421
330122313013233
120340422213331
400111143321320
414410020322023
233143010440021
012243114424424
241103330440020
321304423021131
043312022123001
434211304141420
213201401404043
#
012134321212234
400130420444211
300121130032400
421441400320220
334212413404230
044122144233441
311322032344320
241320244414400
142120330133243
223211001131243
210220322141140
013210400330304
121343113004314
033311400424103
303214033122042
#
201443142040401
330211142434210
414412111231033
442330203214414
141333102222230
042303101131321
202411213111222
133311003302111
000441324100330
432313334312211
111120214131112
012104023100010
011433440010124
322114021010444
401122434124434
#
022241204023022
444222123230021
320123243104202
212002234322213
020320212223302
310430110300234
034134311331213
423110334411443
304111331411442
213022424211220
013244000422422
301241033104022
421422220210430
043202324211134
424402013424231
#
022443333043023
414441314103021
041303133240432
123342102333234
041411230213102
313413314332440
024410032323332
014331213231202
020231341102141
034002324330003
240220310232323
431143113130413
421133030403430
124424341430002
433233001123342
#
441411240330120
411431122302403
323401402441230
043402404441434
401420124301443
314221212242122
242040343023330
343400011412133
444124240141443
042240313241444
002140243400430
421022422233100
413343132113142
114043320243140
331414040430440
#
301330010024001
122322040232221
310000441313204
010203432302034
232203300303411
033204124124410
324041432114002
141304032320001
000142104443104
333103120243411
111302230434411
020020013023024
433240004310412
223204200414401
341440000102100