-1,-1,-1,-1
-1,5,5,5,-1
-1,5,5,3,-1
-1,5,4,0,-1
-1,-1,-1,-1